{
    "tileset_name": "generic_0",
    "music": "",
    "background_img": "",
    "entities": [],
    "map_data": [
        [0,0,0,0,0,0,0,0,0,0,0,0,0,0,0,0,0,0,0,0,0,0,0,0,0,0,0,0,0,0,0,0,0,0,0,0,0,0,0,0,0,0,0,0,0,0,0,0,0,0,0,0,0,0,0,0],
        [0,0,0,0,0,0,0,0,0,0,0,0,0,0,0,0,0,0,0,0,0,0,0,0,0,0,0,0,0,0,0,0,0,0,0,0,0,0,0,0,0,0,0,0,0,0,0,0,0,0,0,0,0,0,0,0],
        [0,0,0,0,0,0,0,0,0,0,0,0,0,0,0,0,0,0,0,0,0,0,0,0,0,0,0,0,0,0,0,0,0,0,0,0,0,0,0,0,0,0,0,0,0,0,0,0,0,0,0,0,0,0,0,0],
        [0,0,0,0,0,0,0,0,0,0,0,0,0,0,0,0,0,0,0,0,0,0,0,0,0,0,0,0,0,0,0,0,0,0,0,0,0,0,0,0,0,0,0,0,0,0,0,0,0,0,0,0,0,0,0,0],
        [0,0,0,0,0,0,0,0,0,0,0,0,0,0,0,0,0,0,0,0,0,0,0,0,0,0,0,0,0,0,0,0,0,0,0,0,0,0,0,0,0,0,0,0,0,0,0,0,0,0,0,0,0,0,0,0],
        [0,0,0,0,0,0,0,0,0,0,0,0,0,0,0,0,0,0,0,0,0,0,0,0,0,0,0,0,0,0,0,0,0,0,0,0,0,0,0,0,0,0,0,0,0,0,0,0,0,0,0,0,0,0,0,0],
        [0,0,0,0,0,0,0,0,0,0,0,0,0,0,0,0,0,0,0,0,0,0,0,0,0,0,0,0,0,0,0,0,0,0,0,0,0,0,0,0,0,0,0,0,0,0,0,0,0,0,0,0,0,0,0,0],
        [0,0,0,0,0,0,0,0,0,0,0,0,0,0,0,0,0,0,0,0,0,0,0,0,0,0,0,0,0,0,0,0,0,0,0,0,0,0,0,0,0,0,0,0,0,0,0,0,0,0,0,0,0,0,0,0],
        [0,0,0,0,0,0,0,0,0,0,0,0,0,59,59,59,59,59,59,59,59,59,59,59,59,59,59,59,59,59,59,59,59,59,59,59,59,59,59,59,59,59,59,59,59,59,59,59,59,59,59,59,59,59,59,59],
        [0,0,0,0,0,0,0,0,0,0,0,0,0,67,0,0,66,0,0,0,0,66,0,0,0,0,0,0,0,0,0,0,0,0,0,0,0,0,0,0,0,0,0,0,5,0,0,0,0,0,0,0,0,0,0,5],
        [0,0,0,0,0,0,0,0,0,0,0,0,0,67,0,0,66,0,0,0,0,66,0,0,0,59,59,59,0,0,67,0,66,58,58,58,58,67,0,5,5,5,0,0,5,0,0,0,0,0,0,0,0,0,0,5],
        [0,0,0,0,0,0,0,0,0,0,0,0,0,67,0,0,66,0,0,0,0,66,59,59,0,67,0,0,0,0,67,0,0,0,0,0,0,67,0,5,5,5,0,0,5,0,0,0,0,0,0,0,0,0,0,5],
        [0,0,0,0,0,0,0,0,0,0,0,0,0,67,0,0,0,0,5,5,0,0,0,0,0,0,0,66,0,0,67,0,59,59,0,0,0,67,0,0,0,0,0,0,5,0,0,0,0,0,0,0,0,0,59,5],
        [0,0,0,0,0,0,0,0,0,0,0,0,0,67,0,0,0,0,5,5,0,59,59,59,0,0,0,66,0,0,0,0,0,66,0,59,59,67,0,0,0,0,0,0,5,0,0,0,0,0,0,0,0,0,0,5],
        [0,0,0,0,0,0,0,0,0,0,0,0,0,67,0,0,66,0,0,0,0,0,0,66,0,0,0,66,0,0,0,0,0,66,0,0,0,0,0,5,5,5,0,0,5,0,0,0,0,0,0,0,0,0,58,5],
        [0,0,0,0,0,0,0,0,0,0,0,0,0,67,0,0,66,0,0,0,0,0,0,66,0,0,0,66,0,0,67,0,58,58,0,0,0,0,0,5,5,5,0,0,5,0,0,0,0,0,0,0,0,0,0,5],
        [0,0,0,0,0,0,0,0,0,0,0,0,0,67,0,0,66,0,0,0,0,0,0,66,0,0,0,66,0,0,67,0,0,0,0,0,0,0,0,0,0,0,0,0,5,0,0,0,0,0,0,0,0,0,0,5],
        [0,0,0,0,0,0,0,0,0,0,0,0,0,67,0,0,66,0,0,0,0,0,0,66,0,0,0,66,0,0,67,0,0,0,0,0,0,0,0,0,0,0,0,0,0,0,0,0,0,0,0,0,0,0,0,5],
        [0,0,0,0,0,0,0,0,0,0,0,0,0,58,58,58,58,58,58,58,58,58,58,58,58,58,58,58,58,58,58,58,58,58,58,58,58,58,58,58,58,58,58,58,58,58,58,58,58,58,58,58,58,58,58,58],
        [0,0,0,0,0,0,0,0,0,0,0,0,0,0,0,0,0,0,0,0,0,0,0,0,0,0,0,0,0,0,0,0,0,0,0,0,0,0,0,0,0,0,0,0,0,0,0,0,0,0,0,0,0,0,0,0]
    ]
}